This pathway describes the activation of the human MAPK signaling system during human coronavirus infection, per Fung and Liu, Figure 7 [10.1146/annurev-micro-020518-115759]. The MAPK signaling system regulates response to different environmental stimuli, e.g. inflammation due to infection. Its downstream effects include regulation of cell cycle, apoptosis, differentiation and immune response. During coronavirus infection, three MAPK signaling pathways were studied and described. The p38 pathway (MAPK11 - MAPK14) leads to stimulation of apoptosis via CHOP (DDIT3) while the ERK pathway (MAPK1 and MAPK3) counteracts apoptosis stimulation and supports cell survival by stimulating ATF2 and FOS. The JNK pathway (MAPK 8 - MAPK10) inhibits cell survival protein BCL2, thus stimulating apoptosis but also stimulating the AP1 complex that leads to the production of effectors to fight the infection. The interplay of apoptosis stimulation and cell survival is not yet fully understood in SARS-CoV-2 infection. 

[DataNode:-]	Empty GraphId found. Replacing with: gen_dn_0
[DataNode:-]	Empty GraphId found. Replacing with: gen_dn_1
[DataNode:-]	Empty GraphId found. Replacing with: gen_dn_2
[DataNode:-]	Empty GraphId found. Replacing with: gen_dn_3
[DataNode:-]	Empty GraphId found. Replacing with: gen_dn_4
[DataNode:-]	Empty GraphId found. Replacing with: gen_dn_5
[DataNode:-]	Empty GraphId found. Replacing with: gen_dn_6
[DataNode:-]	Empty GraphId found. Replacing with: gen_dn_7
[DataNode:-]	Empty GraphId found. Replacing with: gen_dn_8
[STIMULATION:id7c30bf1f]	Invalid interaction type.
[STIMULATION:id63f652b7]	Invalid interaction type.
[STIMULATION:idc1c0f088]	Invalid interaction type.
[STIMULATION:id198c85f]	Invalid interaction type.
[STIMULATION:id62eba7d3]	Invalid interaction type.
[TRANSCRIPTION_TRANSLATION:ide8866e40]	Invalid interaction type.
[TRANSCRIPTION_TRANSLATION:ea117]	Invalid interaction type.
[STIMULATION:id3d6c0762]	Invalid interaction type.
[STIMULATION:ide06bd151]	Invalid interaction type.
[STIMULATION:ida2a9cdb0]	Invalid interaction type.
[STIMULATION:ideee7f970]	Invalid interaction type.
[STIMULATION:id54d4a9a9]	Invalid interaction type.
[STIMULATION:idc07c34c7]	Invalid interaction type.
[STIMULATION:idbeaaca30]	Invalid interaction type.
[TRANSCRIPTION_TRANSLATION:idc72f872e]	Invalid interaction type.
[STIMULATION:idda26811d]	Invalid interaction type.
[STIMULATION:id352f2389]	Invalid interaction type.
[STIMULATION:id80dca1f4]	Invalid interaction type.
[STIMULATION:ided0c8de7]	Invalid interaction type.
[STIMULATION:id589b86fe]	Invalid interaction type.
[STIMULATION:id2520366d]	Invalid interaction type.
[STIMULATION:id81131143]	Invalid interaction type.
[STIMULATION:id9808cc66]	Invalid interaction type.
[STIMULATION:id60fca41b]	Invalid interaction type.
[TRANSCRIPTION_TRANSLATION:ad2dd]	Invalid interaction type.
[STIMULATION:id79ad2aef]	Invalid interaction type.
[TRANSCRIPTION_TRANSLATION:f1e34]	Invalid interaction type.
[STIMULATION:idac31cf2f]	Invalid interaction type.
[STIMULATION:idfb2829ab]	Invalid interaction type.
[STIMULATION:id559f5826]	Invalid interaction type.
[STIMULATION:id1b1215f4]	Invalid interaction type.
[STIMULATION:id4b1d8b89]	Invalid interaction type.
[STIMULATION:id264ad72f]	Invalid interaction type.
[STIMULATION:ide012a8a5]	Invalid interaction type.
[STIMULATION:id392d909b]	Invalid interaction type.
[STIMULATION:idcac13c17]	Invalid interaction type.
[STIMULATION:id6fd5bed2]	Invalid interaction type.
[BiopaxReference:b6f]	Publication type is not supported.
[BiopaxReference:b6f]	Publication type is not supported.
[BiopaxReference:b6f]	Publication type is not supported.
[BiopaxReference:b6f]	Publication type is not supported.
[BiopaxReference:b6f]	Publication type is not supported.
[Label:d18f3]	 Label cannot be part of reaction. Tranforming to Unknown
[Label:fac82]	 Label cannot be part of reaction. Tranforming to Unknown
[Label:f2195]	 Label cannot be part of reaction. Tranforming to Unknown
[Label:d2a7f]	 Label cannot be part of reaction. Tranforming to Unknown
[Label:e47a2]	 Label cannot be part of reaction. Tranforming to Unknown
[Label:ff1ce]	 Label cannot be part of reaction. Tranforming to Unknown
[ReducedPhysicalStimulationReaction:ideee7f970]	Reaction should contain only one reactant and one product.
[ReducedPhysicalStimulationReaction:id589b86fe]	Reaction should contain only one reactant and one product.
[Complex:b956f]	Empty element is invalid
