SARS-CoV-2 Innate immunity evasion mechanisms and cell-specific immune responses; Metabolic overview over ATII cells infection

[DataNode:-]	Empty GraphId found. Replacing with: gen_dn_0
[DataNode:-]	Empty GraphId found. Replacing with: gen_dn_1
[DataNode:-]	Empty GraphId found. Replacing with: gen_dn_2
[DataNode:-]	Empty GraphId found. Replacing with: gen_dn_3
[DataNode:-]	Empty GraphId found. Replacing with: gen_dn_4
[DataNode:-]	Empty GraphId found. Replacing with: gen_dn_5
[DataNode:-]	Empty GraphId found. Replacing with: gen_dn_6
[DataNode:-]	Empty GraphId found. Replacing with: gen_dn_7
[DataNode:-]	Empty GraphId found. Replacing with: gen_dn_8
[DataNode:-]	Empty GraphId found. Replacing with: gen_dn_9
[DataNode:-]	Empty GraphId found. Replacing with: gen_dn_10
[DataNode:-]	Empty GraphId found. Replacing with: gen_dn_11
[TRANSCRIPTION_TRANSLATION:e849d]	Invalid interaction type.
[STIMULATION:ba969]	Invalid interaction type.
[TRANSCRIPTION_TRANSLATION:ccae3]	Invalid interaction type.
[STIMULATION:e3a24]	Invalid interaction type.
[STIMULATION:a69de]	Invalid interaction type.
[STIMULATION:c290b]	Invalid interaction type.
[TRANSCRIPTION_TRANSLATION:b2f3d]	Invalid interaction type.
[STIMULATION:df020]	Invalid interaction type.
[STIMULATION:e021e]	Invalid interaction type.
[LINE:cb2d0]	Invalid interaction type.
[LINE:c1910]	Invalid interaction type.
[STIMULATION:b4cf0]	Invalid interaction type.
[STIMULATION:d6494]	Invalid interaction type.
[LINE:d7cd0]	Invalid interaction type.
[TRANSCRIPTION_TRANSLATION:idde2be3e1]	Invalid interaction type.
[LINE:a4481]	Invalid interaction type.
[STIMULATION:de802]	Invalid interaction type.
[STIMULATION:f6ee1]	Invalid interaction type.
[STIMULATION:bcb8e]	Invalid interaction type.
[STIMULATION:b2c4d]	Invalid interaction type.
[STIMULATION:bfa83]	Invalid interaction type.
[TRANSCRIPTION_TRANSLATION:a0f18]	Invalid interaction type.
[STIMULATION:c18f7]	Invalid interaction type.
[LINE:f5be7]	Invalid interaction type.
[STIMULATION:f8c93]	Invalid interaction type.
[STIMULATION:e32a1]	Invalid interaction type.
[LINE:fc186]	Invalid interaction type.
[LINE:fdd8b]	Invalid interaction type.
[STIMULATION:f12ae]	Invalid interaction type.
[LINE:f5bcb]	Invalid interaction type.
[LINE:bc934]	Invalid interaction type.
[LINE:b2c03]	Invalid interaction type.
[STIMULATION:f692c]	Invalid interaction type.
[STIMULATION:a0131]	Invalid interaction type.
[STIMULATION:c94fa]	Invalid interaction type.
[NETosis:a5b14]	 Shape can not be part of reaction. Tranforming to Unknown
[dsRNA:cb56c]	 Shape can not be part of reaction. Tranforming to Unknown
[:cfc78]	 Shape can not be part of reaction. Tranforming to Unknown
[Protein synthesis:ec9ad]	 Shape can not be part of reaction. Tranforming to Unknown
[ISGs:ad145]	 Shape can not be part of reaction. Tranforming to Unknown
[Neutrophil recruitment:e62ae]	 Shape can not be part of reaction. Tranforming to Unknown
[Cytotoxic Function:e0973]	 Shape can not be part of reaction. Tranforming to Unknown
[Viral particle:fbdf9]	 Shape can not be part of reaction. Tranforming to Unknown
[:cef7e]	 Shape can not be part of reaction. Tranforming to Unknown
[:fd08c]	 Shape can not be part of reaction. Tranforming to Unknown
[Regulation of MHC II 
expression and cytokine production:f8f8f]	 Shape can not be part of reaction. Tranforming to Unknown
[RBD
:c59c3]	 Shape can not be part of reaction. Tranforming to Unknown
[Antiproliferative activity:adf72]	 Shape can not be part of reaction. Tranforming to Unknown
[Viral particle:f62f1]	 Shape can not be part of reaction. Tranforming to Unknown
[DMV:d806a]	 Shape can not be part of reaction. Tranforming to Unknown
[BiopaxReference:ba1]	Publication type is not supported.
[HeterodimerAssociationReaction:f6131]	Reaction should contain at least 2 reactants. GraphId: f6131
[BiopaxReference:ba1]	Publication type is not supported.
[HeterodimerAssociationReaction:cc670]	Reaction should contain at least 2 reactants. GraphId: cc670
[HeterodimerAssociationReaction:adadb]	Reaction should contain at least 2 reactants. GraphId: adadb
[BiopaxReference:ba1]	Publication type is not supported.
[HeterodimerAssociationReaction:b21db]	Reaction should contain at least 2 reactants. GraphId: b21db
[HeterodimerAssociationReaction:eb412]	Reaction should contain at least 2 reactants. GraphId: eb412
[ReducedPhysicalStimulationReaction:b4cf0]	Reaction should contain only one reactant and one product.
[ReducedPhysicalStimulationReaction:d6494]	Reaction should contain only one reactant and one product.
[BiopaxReference:c71]	Publication type is not supported.
[HeterodimerAssociationReaction:ab09f]	Reaction should contain at least 2 reactants. GraphId: ab09f
[BiopaxReference:ba1]	Publication type is not supported.
[ReducedPhysicalStimulationReaction:b2c4d]	Reaction should contain only one reactant and one product.
[BiopaxReference:c58]	Publication type is not supported.
[HeterodimerAssociationReaction:b66f3]	Reaction should contain at least 2 reactants. GraphId: b66f3
[-:-]	Miriam data (PUBMED: 33335518) for c18f7 already exists. Ignoring...
[ReducedPhysicalStimulationReaction:c18f7]	Reaction should contain only one reactant and one product.
[HeterodimerAssociationReaction:f5211]	Reaction should contain at least 2 reactants. GraphId: f5211
[HeterodimerAssociationReaction:e0d71]	Reaction should contain at least 2 reactants. GraphId: e0d71
[HeterodimerAssociationReaction:e782a]	Reaction should contain at least 2 reactants. GraphId: e782a
[-:-]	Miriam data (PUBMED: 33335518) for f12ae already exists. Ignoring...
[ReducedPhysicalStimulationReaction:f12ae]	Reaction should contain only one reactant and one product.
[BiopaxReference:aed]	Publication type is not supported.
[-:-]	Miriam data (PUBMED: 33335518) for e97bb already exists. Ignoring...
[UnknownPositiveInfluenceReaction:e97bb]	Reaction should contain only one reactant and one product.
[HeterodimerAssociationReaction:d6cd5]	Reaction should contain at least 2 reactants. GraphId: d6cd5
[HeterodimerAssociationReaction:d1890]	Reaction should contain at least 2 reactants. GraphId: d1890
[Complex:eb4ec]	Empty element is invalid
